ARRB2	Dopaminergic
ATP1A3	Dopaminergic
CAV2	Dopaminergic
CLIC6	Dopaminergic
DLG4	Dopaminergic
DNAJC14	Dopaminergic
DNM1	Dopaminergic
DNM2	Dopaminergic
DRD1	Dopaminergic
DRD3	Dopaminergic
GNA12	Dopaminergic
GNA13	Dopaminergic
GNAS	Dopaminergic
PALM	Dopaminergic
PPP1R1B	Dopaminergic
PTPN11	Dopaminergic
SLC9A3R1	Dopaminergic
GRIA1	Glutamatergic
GRIA2	Glutamatergic
GRIA3	Glutamatergic
GRIA4	Glutamatergic
GRID1	Glutamatergic
GRID2	Glutamatergic
GRIK1	Glutamatergic
GRIK2	Glutamatergic
GRIK3	Glutamatergic
GRIK4	Glutamatergic
GRIK5	Glutamatergic
GRIN1	Glutamatergic
GRIN2A	Glutamatergic
GRIN2B	Glutamatergic
GRIN2C	Glutamatergic
GRIN2D	Glutamatergic
GRIN3A	Glutamatergic
GRIN3B	Glutamatergic
GRM1	Glutamatergic
GRM2	Glutamatergic
GRM3	Glutamatergic
GRM4	Glutamatergic
GRM5	Glutamatergic
GRM6	Glutamatergic
GRM7	Glutamatergic
GRM8	Glutamatergic
PTK2B	Glutamatergic
HTR1A	Serotonergic
HTR1B	Serotonergic
HTR1D	Serotonergic
HTR1E	Serotonergic
HTR1F	Serotonergic
HTR2A	Serotonergic
HTR2B	Serotonergic
HTR2C	Serotonergic
HTR3A	Serotonergic
HTR3B	Serotonergic
HTR3C	Serotonergic
HTR3D	Serotonergic
HTR3E	Serotonergic
HTR4	Serotonergic
HTR5A	Serotonergic
HTR6	Serotonergic
HTR7	Serotonergic
ZACN	Serotonergic